215 216 215 216 215 216 215 216 215 216 215 216 -1 32 33 34 34 35 34 35 34 35 34 35 34 35 34 35 34 35
231 232 231 232 231 232 231 232 231 232 231 232 -1 48 49 50 50 51 50 51 50 51 50 51 50 51 50 51 50 34
247 248 247 248 247 248 247 248 247 248 247 248 -1 64 65 66 66 66 66 66 66 66 66 66 66 66 66 66 50 50
201 202 -1 -1 -1 -1 -1 -1 -1 -1 -1 -1 -1 80 81 82 82 82 82 82 82 82 82 82 82 82 70 71 49 50
217 218 -1 -1 -1 -1 -1 -1 -1 -1 -1 -1 -1 96 97 98 98 98 98 98 98 98 98 98 98 98 86 87 49 50
233 234 -1 -1 -1 -1 -1 -1 155 156 156 156 156 156 156 156 156 156 156 156 156 157 -1 -1 -1 -1 102 103 33 34
249 250 -1 -1 -1 -1 -1 -1 171 42 42 42 42 42 42 42 42 42 42 42 42 173 -1 -1 -1 -1 -1 48 49 50
201 202 -1 -1 -1 -1 -1 -1 171 42 59 60 60 60 60 60 60 60 60 61 42 173 -1 -1 -1 -1 -1 32 33 34
217 218 -1 -1 -1 -1 -1 -1 171 42 75 76 76 76 76 76 76 76 76 77 42 173 -1 -1 -1 -1 -1 48 49 50
233 234 -1 -1 -1 -1 -1 -1 171 42 75 76 76 76 76 76 76 76 76 77 42 173 -1 -1 -1 -1 -1 32 33 34
249 250 -1 -1 -1 -1 -1 -1 171 42 75 76 76 76 76 76 76 76 76 77 42 173 -1 -1 -1 -1 -1 48 49 50
201 202 -1 -1 -1 -1 -1 -1 171 42 75 76 76 76 76 76 76 76 76 77 42 173 -1 -1 -1 -1 -1 32 33 34
217 218 -1 -1 -1 -1 -1 -1 171 42 91 92 92 92 92 92 92 92 92 93 42 173 -1 -1 -1 -1 -1 48 49 50
233 234 -1 -1 -1 -1 -1 -1 171 42 42 42 42 42 42 42 42 42 42 42 42 173 -1 -1 -1 -1 -1 32 33 34
249 250 -1 -1 -1 -1 -1 -1 187 188 188 188 188 188 188 188 188 188 188 188 188 189 -1 -1 -1 -1 -1 64 65 66
201 202 -1 -1 -1 -1 -1 -1 -1 -1 -1 -1 -1 -1 -1 -1 -1 -1 -1 -1 -1 -1 -1 -1 -1 -1 -1 80 81 82
217 218 -1 -1 -1 -1 -1 -1 -1 -1 -1 -1 -1 -1 -1 -1 -1 -1 -1 -1 -1 -1 -1 -1 -1 -1 -1 96 97 98
233 234 -1 -1 -1 -1 -1 -1 -1 -1 -1 -1 -1 -1 -1 -1 -1 -1 -1 -1 -1 -1 -1 -1 -1 -1 -1 -1 -1 -1
249 250 -1 -1 -1 -1 -1 -1 -1 -1 -1 -1 -1 -1 -1 -1 -1 -1 -1 -1 -1 -1 -1 -1 -1 -1 -1 -1 -1 -1
201 202 -1 -1 -1 -1 -1 -1 -1 -1 -1 -1 -1 -1 -1 -1 -1 -1 -1 -1 -1 -1 -1 -1 -1 -1 -1 -1 -1 -1
